                                                                                
     *                 *                             *                          
      * It is written in the stars that     *                        *          
 *       "Jaek is a bollocking wanker"                                          
                    ...                *                                        
                                                                |               
                                            *           *      _|___LL_         
           *                                                  /== # ===\        
                                                             /0000#00000\       
                        * *                                   0   #    0        
                                                              [ 2 #    ]        
                                  __LL___                     0000#00000        
      *                          /0000000\       _LL__        0   #    0        
                                  0 X X 0       /00000\       +   #1   +      @ 
 		    _LL_ 	  [     ]      /0     0\    00000000000000000000
 		   /0000\	  +  4  +   u   +  3  +    000000000000000000000
                   0    0     00000000000000F00000000000000000000000000000000000
     ___           +  5 +    000000000000000F00000000000000000000000000000000000
    /000\      00000000000000000000000000000F00000000000000000000000000000000000
   /0   0\    000000000000000000000000000000F00000000000000000000000000000000000
    +   +    0000000000000000000000000000000F00000000000000000000000000000000000
00000000000000000000000000000000000000000000F00000000000000000000000000000000000
00000000000000000000000000000000000000000000FFFFFFFFFFFFFFFFFFFFFFFFFFFFFFFFFFFF
00000000000000000000000000000000000000000000F00000000000000000000000000000000000
00000000000000000000000000000000000000000000000000000000000000000000000000000000