                                                                                
     *                 *                             *                          
      *                                     *                        *          
 *                                                                              
                                       *                                        
                                                                |               
                                            *           *      _|___LL__        
           *                                                  /== # ====\       
                                                             /0000#000000\      
                        * *                                   0   #     0       
                                                              [ 2 #     ]       
                                  __LL___.....................0000#000000       
......*........................../0000000\......__LL___.......0   #     0       
..................................0 X X 0....../0000000\......+   #1    +     @ 
..................___LL__.........[     ].......0     0.....00000000000000000000
..................0000000.........+  4  +   u   +  3  +....000000000000000000000
..................0     0.....00000000000000000000000000000000000000000000000000
....._____........+   5 +    000000000000000000000000000000000000000000000000000
   ./00000\.....0000000000000000000000000000000000000000000000000000000000000000
   ..0   0    .00000000000000000000000000000000000000000000000000000000000000000
    .+   +   .000000000000000000000000000000000000000000000000000000000000000000
00000000000000000000000000000000000000000000000000000000000000000000000000000000
00000000000000000000000000000000000000000000000000000000000000000000000000000000
~~`~`~~~``~~`~`~`~~~``~~``~```~`~`~`~`~~`~``~```~~```~`~```~~~``~`~~```~`~~~`~`~
,,,,,,,,,,,,,,,,,,,,,,,,,,,,,,,,,,,,,,,,,,,,,,,,,,,,,,,,,,,,,,,,,,,,,,,,,,,,,,,,